---
Tiles
stars:4,6,9
CXXX1BFXXXCX
XCBBBBBXXCBB
XXBBXXBBX3XC
SXXBX2XXCBXX
XCXXBCCbBBXX
XBXXBXBXXXCX
XCCXXXXCXBCX
---
Owl
loops:false
seconds_between_flights:2
dXXXcXXXXXXX
XXXXXXXXXXXX
XXXXXXXXXXXX
XXXXXXXXXXXX
aXXXbXXXXXXX
XXXXXXXXXXXX
XXXXXXXXXXXX
---
Owl
loops:false
seconds_between_flights:3
XXXXXXXXXXXX
XXXXXXXXXXXX
XXXXXXbXXXXa
XXXXXXXXXXXX
XXXXXXXXXXXX
XXXXXXXXXXXX
XXXXXXcXXXXX
---
Owl
speed:15
XXXXXXcXXXbX
XXXXXXXXXXXX
XXeXXXdXXXXX
XXXXXXXXXXXX
XXXXXXXXXXXX
XXfXXXXXXXaX
XXXXXXXXXXXX