---
Tiles
stars:4,6,9
XbBCXBBXXB4B
CCCXX2XXBBXF
BBXXCBBXCBXB
SXXXCCbXXXXC
BBCXXXXXXBBb
BBX1CXXBCB3X
BBbBCCBBXXXX
---
Hawk
loops:false
seconds_between_flights:2
XXXXXXXXXXXX
XXXXXXXXXXXX
XXXXXXXXXXXX
XXXXXXXXXXXX
XXXXXXXXXXXX
bXXXXXXXXXXa
XXXXXXXXXXXX
---
Hawk
loops:false
seconds_between_flights:2
start_delay:2
XXXXXXXXXXXX
aXXXXXXXXXXb
XXXXXXXXXXXX
XXXXXXXXXXXX
XXXXXXXXXXXX
XXXXXXXXXXXX
XXXXXXXXXXXX
---
Hawk
XXXXXXXXXXXX
XXXaXXXXXXdX
XXXXXXXXXXXX
XXXXXXXXXXXX
XXXXXXXXXXXX
XXXbXXXXXXcX
XXXXXXXXXXXX
