---
Tiles
stars:4,6,9
XCCBBBBBXCXB
BBX1CCBXCBBB
BXXBXXXXCCXB
SXCCXBC2XBXX
XXBXCBBBXBCX
BBC3XXXXXBXB
XCXXBBBXFBCC
---
Owl
speed:15
XXXXXXXXXXXX
XXXXXXXXXXXX
XXXdXXXXaXXX
XXXXXXXXXXXX
XXXXXXXXXXXX
XXXcXXXXbXXX
XXXXXXXXXXXX
---
Owl
speed:15
XXXXXXXXXXXX
XXXXXXXXXXXX
XXXbXXXXcXXX
XXXXXXXXXXXX
XXXXXXXXXXXX
XXXaXXXXdXXX
XXXXXXXXXXXX