---
Tiles
BXCXXbXXCXXX
BBBX2BXBBBBF
XCXXCCXXXCBX
SXBBXBCBX1CX
XXXXXCXBBXXX
BCXbBBX4BB3C
XCCXBXCXBBXC
---
Hawk
XXXXXXXXXXXX
XXcXXXbXXXXX
XXXXXXXXXXXX
XXXXXXXXXXXX
XXdXXXXXXeXX
XXXXXXXXXXXX
XXXXXXaXXfXX
