---
Tiles
stars:4,6,9
C2CXXXBBBBBB
BBBXBXCBBBB4
XXXXXXXXXXXX
SXBXBCBXXXBB
BBbXBXXX1XXC
XXXXBCBBXXBB
FXX3XXXXXXBB
---
Roadrunner
chase_player:true
XXXXXXXXXXXX
XXXXXXXXXXXX
XXXcXXXdXXXX
XXXXXXXeXfXX
XXXXXXXXXXXX
XXXbXXXXXXXX
XXXaXXXXXgXX
---
Roadrunner
loops:false
speed:7
seconds_between_flights:3
XXXXXXXXXXXX
XXXXXXXXXXXX
bXXXXXXXXXXa
XXXXXXXXXXXX
XXXXXXXXXXXX
XXXXXXXXXXXX
XXXXXXXXXXXX