---
Tiles
X2XXXXBXXXXX
BBBXBXXBXBBX
XXXXXXXXCCBX
SXBXBCBXXXBB
BBbXBXXX1XXX
XXXXBCBBXXBX
FXX3XXXXXXBX
---
Roadrunner
XXXXXXXXXXXX
XXXXXXXXXXXX
XXXcXXXdXXXX
XXXXXXXeXfXX
XXXXXXXXXXXX
aXXbXXXXXXXX
hXXXXXXXXgXX
