---
Tiles
BCTTCBBBFXBB
BbBXXCXXXXXX
XXXXBBXEBEXB
SXXXBBXCBBXC
XXXEBBXXXXXC
XXBBBXXBXXBB
XXXXXXXBXXEX
---
Roadrunner
XXXXXXXXXXXX
XXXaXXXXXXlX
XXXXXXXXXXXX
XXXXXXXXXXXX
XcXbXXfXgjkX
XXXXXXXXXXXX
XdXXXXeXhiXX
---
Roadrunner
XXXXXXXXXXXX
XXXbXXXaXXmX
XXXXXXXXXXXX
XXXXXXXXXXXX
XdXcXXgXhklX
XXXXXXXXXXXX
XeXXXXfXijXX
