FXXXXXXXXXXX
TTTXTTTECXXX
XXTXTXTXTTXX
XXTTTCXXXCXX
XXCTTXXXXTTS
XXXXTCXXXXXX
XXXXTTTECXXX