---
Tiles
BCTTCBBBFXBB
BbBXXXXXXXXX
XXX4BBX1BXXB
SXXXBBXCBBXC
XXX3BBXXXXXC
CXBBBXXBXXBB
XXXXXXXBXX2X
---
Hawk
mXXXXaXXXbXX
XXXXXXXXXXXX
lXkXXXdXXcXX
XXXXXXXXXXXX
XXXXXXeXXXfX
XXjXXXXiXXXX
XXXXXXXhXXgX
