---
Tiles
BBCBBBBBBBXF
BXXXXXXXXXXB
BXBB1XXBbXXB
SXCBXXX2BCXB
BXXBBXCCXXXB
BXX3XXXXXXXB
BBBBBBBBBXXB
---
Roadrunner
XXXXXXXXXXXX
XcXXXXXXXXbX
XXXXXXXXXXXX
XXXXXXXXXXXX
XXXXXXXXXXXX
XdXXXXXXXeXX
XXXXXXXXXfaX
---
Owl
XXXXXXXXXXXX
XXXXXXXXXXXX
XXbXXXXaXXXX
XXXXXXXXXXXX
XXcXXXXdXXXX
XXXXXXXXXXXX
XXXXXXXXXXXX