---
Tiles
BCTTCBBBFXBB
BbBXXXXXXXXX
XXX4BBX1BXXB
SXXXBBXCBBXC
XXX3BBXXXXXC
CXBBBXXBXXBB
XXXXXXXBXX2X
---
Hawk
loop:0
seconds_between_flights:3
XXXXXXXXXXaX
XXXXXXXXXXXX
XXXXXXXXXXXX
XXXXXXXXXXXX
XXXXXXcXXXbX
eXXXXXdXXXXX
XXXXXXXXXXXX