TTTTTTTTTTTT
TXXXXEXXTXXT
TTTTXXXXTEXT
TXXTCTXXTTTT
TXXCCTXXCXXT
TXXXXTXXXXXT
TTTTTTTTTTTT