---
Tiles
BCTTCBBBFXBB
BbBXXXXXXXXX
XXXXBBX1B2XB
SXXXBBXCBBXC
XXXBBXXXXXC
CXBBBXXBXXBB
XXXXXXXBXX3X
---
Roadrunner
XXXXXXXXXXXX
XXXaXXXXXXhX
XXXXXXXXXXXX
XXXXXXXXXXXX
XcXbXXfXXXgX
XXXXXXXXXXXX
XdXXXXeXXXXX
---
Roadrunner
XXXXXXXXXXXX
XXXbXXXXXXaX
XXXXXXXXXXXX
XXXXXXXXXXXX
XdXcXXgXXXhX
XXXXXXXXXXXX
XeXXXXfXXXXX