TTTTTTTTTTTT
XBXBXXXETXXF
TTBTBXXXXXXT
BXXBXBXXbXXT
BXXCBTXXXXXT
TXBXXXXXSXBT
TTTTTTTTTTTT