TTTTTTTTTTTT
XBXBXXXETXXF
TTBTBXXXTEXT
BXXBXBXXbTBT
BXXCBTBBCXXT
TXBXXSXXBXBT
TTTTTTTTTTTT