XXXXXXXXXXXX
XXXXXXXXFTTX
XXXXXXXXXXTX
XXSTXXXCETTX
XXXTXXXXXXTX
XXXTTTXXXXTX
XXXXXTTTTTTT