TTTTTTTTTTTT
SXXXXXXETXXF
TTTTXXXXTEXT
TXXTCTXXTTTT
TXXCCTXXCXXT
TXXXXTXXXXXT
TTTTTTTTTTTT