---
Tiles
BCTTCBBBFXBB
BbBXXXXXXXXX
XXX4BBX1BXXB
SXXXBBXCBBXC
XXX3BBXXXXXC
CXBBBXXBXXBB
XXXXXXXBXX2X
---
Roadrunner
XXXXXXXXXXXX
XXXaXXXXXXhX
XXXXXXXXXXXX
XXXXXXXXXXXX
XcXbXXfXXXgX
XXXXXXXXXXXX
XdXXXXeXXXXX
