BXXXXXXXXXXX
BBRRRRRRRRXX
BXRXBXXXBRXX
CXRXBEXXBRXX
XXrXXXXXXRXX
XXRRRRRRRRXX
XBBXXFXXBXXX