XXXXXXXXXXXX
TTTXTTTECXXX
XXTXTXTXXXXX
XXTTTCXXXCXX
XXCTTXXXXXXX
XXXXTCXXXXXX
XXXXTTTECXXX