---
Tiles
BCTTCBBBFXBB
BbBXXXXXXXXX
XXX4BBX1BXXB
SXXXBBXCBBXC
XXX3BBXXXXXC
CXBBBXXBXXBB
XXXXXXXBXX2X
---
Owl
XXXXXXXXXXXX
XXXXXXXXXXXX
XXXXXXXXXXXX
XXXXXXcXXXbX
XXXXXXXXXXXX
XXXXXXdXXXaX
XXXXXXXXXXXX
---
Owl
XXXXXXXXXXXX
XXaXbXXXXXXX
XXXXXXXXXXXX
XXdXcXXXXXXX
XXXXXXXXXXXX
XXXXXXXXXXXX
XXXXXXXXXXXX