TTTTTTTTTTTT
XBXBXXXETXXF
TTBTBXXXTEXT
BXXBXBXXBTBT
BXXCBTBBCXXT
TXBXXSXXBXBT
TTTTTTTTTTTT