BXXXXXXXXXXX
BBBBBSXXBXXX
BXXXBXXXBEXX
CXXXBEXXBXXX
XXXXXXXXXXXX
XXXXCCCXBBXX
XBBXXFXXBXXX