BCXXCBBBFXBB
BbBXXCXXXXXX
XXXXBBXEBEXB
SXXXBBXCBBXC
XXXEBBXXXXXC
XXBBBXXBXXBB
XXXXXXXBXXEX